4 4
1 1 1 1 1 1
1 1 0 0 0 1 
1 0 0 2 0 1 
1 3 2 1 3 1
1 0 0 2 0 1
1 0 0 3 0 1
1 1 1 1 1 1 
